1111111111111111111111
11100010000X00000C0001
100C011110000000100X01
1100000000111111111111
1E0P11110000000C000001
1111111111111111111111