1111111111111111111111
11100010000X00000C0001
100C0111100000X0100001
1100000000111111111111
1E0P11110000000C0000X1
1111111111111111111111